p c c w c c s c c c
c c c c c c c w c c
c c c c c c c c w c
w c c c c c c c c c
c c w c c c w c c c
c c c T07w c c c c c
c T79c c c c c c c c
c c w c c c c c c s
c c c c c w c c c c
c c c c c c c c c g
